//MAP CONVERTED BY dmm2tgm.py THIS HEADER COMMENT PREVENTS RECONVERSION, DO NOT REMOVE
"m" = (
/obj/effect/landmark{
	name = "Memento Mortem Exit";
	dir = 4
	},
/turf/cordon{
	density = 0
	},
/area/awaymission/secret)
"n" = (
/obj/effect/landmark{
	name = "Memento Mortem"
	},
/turf/open/indestructible{
	icon = null;
	icon_state = null
	},
/area/awaymission/secret/fullbright)
"A" = (
/turf/open/indestructible{
	icon = null;
	icon_state = null
	},
/area/awaymission/secret/fullbright)
"D" = (
/obj/effect/landmark{
	name = "Memento Mortem Exit";
	dir = 8
	},
/turf/cordon{
	density = 0
	},
/area/awaymission/secret)
"O" = (
/turf/cordon,
/area/awaymission/secret)

(1,1,1) = {"
O
O
O
O
O
O
O
O
m
O
O
O
O
O
O
O
O
"}
(2,1,1) = {"
O
A
A
A
A
A
A
A
A
A
A
A
A
A
A
A
O
"}
(3,1,1) = {"
O
A
A
A
A
A
A
A
A
A
A
A
A
A
A
A
O
"}
(4,1,1) = {"
O
A
A
A
A
A
A
A
A
A
A
A
A
A
A
A
O
"}
(5,1,1) = {"
O
A
A
A
A
A
A
A
A
A
A
A
A
A
A
A
O
"}
(6,1,1) = {"
O
A
A
A
A
A
A
A
A
A
A
A
A
A
A
A
O
"}
(7,1,1) = {"
O
A
A
A
A
A
A
A
A
A
A
A
A
A
A
A
O
"}
(8,1,1) = {"
O
A
A
A
A
A
A
A
A
A
A
A
A
A
A
A
O
"}
(9,1,1) = {"
O
A
A
A
A
A
A
A
n
A
A
A
A
A
A
A
O
"}
(10,1,1) = {"
O
A
A
A
A
A
A
A
A
A
A
A
A
A
A
A
O
"}
(11,1,1) = {"
O
A
A
A
A
A
A
A
A
A
A
A
A
A
A
A
O
"}
(12,1,1) = {"
O
A
A
A
A
A
A
A
A
A
A
A
A
A
A
A
O
"}
(13,1,1) = {"
O
A
A
A
A
A
A
A
A
A
A
A
A
A
A
A
O
"}
(14,1,1) = {"
O
A
A
A
A
A
A
A
A
A
A
A
A
A
A
A
O
"}
(15,1,1) = {"
O
A
A
A
A
A
A
A
A
A
A
A
A
A
A
A
O
"}
(16,1,1) = {"
O
A
A
A
A
A
A
A
A
A
A
A
A
A
A
A
O
"}
(17,1,1) = {"
O
O
O
O
O
O
O
O
D
O
O
O
O
O
O
O
O
"}
